1,1,1,1,1,1,1,1,1,1,1,1,1,1,1
1,0,0,0,1,0,1,1,1,0,0,0,0,0,1
1,0,1,1,1,0,0,0,0,0,1,1,0,1,1
1,0,0,1,1,1,1,0,1,0,0,0,0,0,1
1,1,0,1,0,0,0,0,1,1,1,1,0,1,1
1,1,0,1,1,1,0,1,1,0,0,1,0,0,1
1,0,0,0,0,1,0,1,0,1,0,1,1,1,1
1,0,1,1,0,0,2,0,0,0,0,0,0,0,1
1,0,1,1,1,1,0,1,1,1,1,0,1,1,1
1,0,0,0,0,1,0,0,0,0,0,0,0,0,1
1,0,1,1,0,1,1,0,1,1,1,0,1,0,1
1,0,1,0,0,0,1,0,0,0,1,1,1,0,1
1,0,1,1,1,0,1,0,1,1,1,0,1,1,1
1,0,1,3,0,0,1,0,0,0,0,0,0,0,1
1,1,1,1,1,1,1,1,1,1,1,1,1,1,1

# 0 = No object
# 1 = Object
# 2 = Agent
# 3 = Goal
